+-------+
| |-|:/j|
| |-|*|^|
|  ^    |
| |--| ||
| |-|  ||
| |-|*|-|
| /   :^|
| |---| D
+-------+
